FFFFFFFFFFFFF
FBFFFFFFFFFBF
FBFFFFFFFFFBF
FBFFFFFFFFFBF
FFFFFFFFFFFBF
FBBBFFFBBBFFF
FFFFFFFFFFFFF
FBFFFFFFFFFBF
FBFFBBBBFFFBF
BBBBBBBBBBBBB
FBFFFFFFFFFBF
FFFFBBBBFFFFF
FFFFFFFFFFFFF