FFFFFFFFFFFFF
FBFFFFFFFFFBF
FBFFFFFFFFFBF
FBFFFFFFFFFBF
FFFFFFFFFFFBF
FBBBFFFBBBFFF
FFFFFFFFFFFFF
FBFFFFFFFFFBF
FBFFBBBBFFFBF
BBBBBBWBBBBBB
FBFEFFFFTFFBF
FFFFBBBBFFFFF
FFFFFFFFFFFFF