FFFFFFFFFFFFF
FBFBFBFBFBFBF
FBFBFBFBFBFBF
FBFBFBSBFBFBF
FTFBFFFFFBFTF
FTBBFFFFFBFTF
FTFBFFFFFBFTF
FBFBFBSBFBFBF
FBFBFBFBFBFBF
FBBBFFFFFBBBF
FBBBFFFFFFBBF
FFFFFFBBBFBBF
FFFFFFBEBFFFF