FFFFFFFFFFFFF
FBFBFBFBFBFBF
FBFBFBFBFBFBF
FBFBFBSBFBFBF
FTFBFFFFFBFTF
FTFFFSSSFFFTF
FTFBFSWSFBFTF
FBFBFSSSFBFBF
FBFBFFFFFBFBF
FBBBFBSBFBBBF
FBBFFFFFFFBBF
FBBFFBBBFFBBF
FFFFFBEBFFFFF