FFFFFFFFFFFFF
FBFBFBFBFBFBF
FBFBFBFBFBFBF
FBFBFBSBFBFBF
FTFBFFFFFBFTF
FTFFFSSSFFFTF
FTFBFFFFFBFTF
FBFBFBSBFBFBF
FBFBFBFBFBFBF
FBBBFFFFFBBBF
FBBBFFFFFFBBF
FFFFFBBBFFBBF
FFFFFBEBFFFFF